8
6
0,0,0,0,0,0
0,4,5,6,7,0
0,5,4,0,2,0
0,6,1,4,2,0
0,7,4,3,0,0
0,8,7,8,4,0
0,3,4,5,6,0
0,0,0,0,0,0