8
6
0,0,0,0,0,0
0,0,5,6,7,0
0,  ,4,0,0,0
0,  1,4,2,0
0,  4,0,0,0
0,  7,0,0,0
0,3,4,5,6,0
0,0,0,0,0,0